あかり	明かり
あした	明日
あたり	当たり
あたる	当たる
あたらない	当たらない
あとで	後で
あぶない	危ない
あめ	雨
あんしん	安心
あんぜん	安全
あんない	案内
いえ	家
いきてた	生きてた
いく	行く
いけない	行けない
いし	石
いっしゅうかん	一週間
いちだん	一段
いちばん	一番
いのち	命
いぬ	犬
いま	今
いまから	今から
いまは	今は
いみ	意味
いりぐち	入り口
いわ	岩
ういてる	浮いてる
うえ	上
うく	浮く
うけると	受けると
うしろ	後ろ
うって	売って
うってる	売ってる
うる	売る
えき	駅
おいて	置いて
おおかみ	狼
おおきい	大きい
おかね	お金
おくゆき	奥行き
おしごと	お仕事
おそい	遅い
おちる	落ちる
おちて	落ちて
おちた	落ちた
おちたら	落ちたら
おちます	落ちます
おてつだい	お手伝い
おと	音
おとした	落とした
おねがい	お願い
おの	斧
おはな	お花
おひる	お昼
おもい	重い
おもう	思う
おれ	俺
かいじょ	解除
かいだん	階段
かいちく	改築
かいとり    買い取り
かいふく	回復
かいほう    解放
かいしゅう	回収
かえたい	変えたい
かえれた	帰れた
かくし	隠し
かくしつうろ	隠し通路
かくしべや	隠し部屋
かず	数
かってに	勝手に
かのうせい	可能性
かみなり	雷
かわいい	可愛い
かんけい	関係
かんし	監視
かんじ	漢字
かんしょう	干渉
かんせい    完成
かんぜん	完全
かんばん    看板
かんり	管理
きあい	気合い
きいて	聞いて
きえた	消えた
きえて	消えて
きえる	消える
きけん	危険
きづいて	気づいて
きて	来て
きのう 昨日
きばく	起爆
きぶん	気分
きもち	気持ち
きもちわるい	気持ち悪い
きょう	今日
きょうどう	共同
きょじゅうく	居住区
きょどう	挙動
きれい	綺麗
くうちゅう	空中
くうどう	空洞
くかく	区画
けいかく	計画
けいけん	経験
けいけんち	経験値
けいげん	軽減
けいざい	経済
けいじばん   掲示板
げいじゅつ	芸術
げいじゅつてき	芸術的
けっこう	結構
げんかい	限界
けんげん    権限
けんせつ	建設
げんち	現地
けんちく	建築
けんちくぶつ	建築物
げんちちょうたく	現地調達
げんぼく	原木
こううん	幸運
こうかん	交換
こうげき	攻撃
こうせき	鉱石
こうど	高度
こうみゃく	鉱脈
こうりつ	効率
こくようせき  黒曜石
ごじゆうに	ご自由に
ごぜん	午前
ごにん	五人
ごはん	ご飯
こまらない	困らない
こまる	困る
こむぎ	小麦
こや	小屋
ごりょうかく	五稜郭
こわい	怖い
こわした	壊した
こわして	壊して
こわれ	壊れ
こわれた	壊れた
さいくつ	採掘
さいしゅう   最終
さいしょ	最初
さいせん	再戦
さいちょうせん	再挑戦
さく	柵
さば	鯖
さばく	砂漠
さがして	探して
さぎょう	作業
さくしゃ	作者
さんだん	三段
さんにん	三人
しかくい	四角い
じかん	時間
しきん	資金
しげん	資源
じこ	事故
しごと	仕事
じっけん	実験
じっさい	実際
してい	指定
じばく	自爆
じぶん	自分
しらかば    白樺
しぬ	死ぬ
しゅうかく	収穫
しゅだん	手段
しゅと	首都
しよう	仕様
しょうきぼ	小規模
しんけん	真剣
しんせん	新鮮
しんだ	死んだ
しんちく	新築
じかん 時間
すうりょう	数量
すてき	素敵
すな  砂
すんぜん	寸前
せいげん	制限
せいち	整地
せきたん    石炭
せってい	設定
せまい	狭い
ぜんぜん	全然
ぜんたい	全体
ぜんぶ 全部
せんろ	線路
そうこ	倉庫
そうぞう	想像
そうてい	想定
そうび	装備
そざい	素材
そと	外
だいきぼ	大規模
だいたい	大体
たいさく	対策
だいじょうぶ	大丈夫
たいりょう   大量
たかい	高い
たかく	高く
たかすぎ	高すぎ
たかすぎた	高すぎた
たかすぎる	高すぎる
たくみ	匠
たしかに	確かに
たすかった	助かった
たすかる	助かる
だっしゅつ	脱出
たてた	建てた
たてる	建てる
たてて	建てて
たてても	建てても
たてもの	建物
たにん	他人
たね	種
たぶん	多分
たべない	食べない
たりない    足りない
だれか	誰か
だんさ	段差
ちえん	遅延
ちか  地下
ちかい	近い
ちがい	違い
ちがう	違う
ちかく	近く
ちかしつ	地下室
ちゅうい	注意
ちゅうおう	中央
ちゅうしん	中心
ちょうせん	挑戦
ちょうたつ	調達
ちゅうとはんぱ	中途半端
ついか	追加
つうろ	通路
つかう	使う
つかって	使って
つかってた	使ってた
つかわない	使わない
つくった	作った
つくって	作って
つくらない	作らない
つくりたい	作りたい
つくる	作る
つち	土
でいりぐち	出入り口
てき	敵
できた	出来た
できたら	出来たら
できてる	出来てる
てきとう	適当
てきとうに	適当に
できなく	出来なく
できない	出来ない
できません	出来ません
できる	出来る
でた	出た
てつ	鉄
てっきょ	撤去
てつだい	手伝い
でてる	出てる
でない	出ない
てま	手間
とう	塔
どうぐ	道具
どうくつ	洞窟
とうめい	透明
どうろ	道路
とった	取った
とどいた	届いた
とどかない	届かない
とどく	届く
とりひき	取引
なかま	仲間
なんせい	南西
なんとう	南東
にがて	苦手
にし	西
にだん	二段
にほんご    日本語
にんき	人気
ねあがり    値上がり
ねこ	猫
ねむい	眠い
ねる	寝る
のぼり	登り
はいおく	廃屋
はいきょ	廃墟
はいれる	入れる
はかい	破壊
ばくだん	爆弾
ばくは	爆破
ばくはつ    爆発
はじめまして	初めまして
はしら	柱
はって	張って
はな	花
はなれた	離れた
はなれて	離れて
はなれてる	離れてる
はぶく	省く
はやい	早い
はやく	早く
はんてい	判定
ばんのう	万能
ひうち	火打ち
ひうちいし	火打ち石
ひかった	光った
ひかって	光って
ひかる	光る
ひくい	低い
ひくく	低く
ひさしぶり	久しぶり
ひさしぶりに	久しぶりに
ひつじ	羊
ひっす	必須
ひとくろう	一苦労
ひとり	一人
ひるま	昼間
ひろい	広い
ひがし	東
ひだりがわ	左側
ひだり	左
ひま	暇
ひょうき	表記
ひょうげん	表現
ひょうめん	表面
ふあん	不安
ふあんてい	不安定
ふえる 増える
ふかさ	深さ
ぶき	武器
ふきとぶ	吹き飛ぶ
ぶざい	部材
ぶじ	無事
ぶた	豚
ふたり	二人
ふつう	普通
へいさ	閉鎖
べっそう	別荘
へや	部屋
へんかん    変換
へんこう	変更
ほうち	放置
ほかく	捕獲
ほくせい	北西
ぼくじょう	牧場
ほくとう	北東
ほしい	欲しい
ほった	掘った
ほる	掘る
ほれた	掘れた
ほんばん	本番
ほんもの	本物
まって	待って
まほう	魔法
まるいし	丸石
まんなか	真ん中
みえる	見える
みえない	見えない
みぎ	右
みぎがわ	右側
みず	水
みなみ	南
みた	見た
みばえ	見栄え
みる	見る
みるまで	見るまで
むずかしい	難しい
むちゃ	無茶
むもんだい	無問題
むり	無理
むりょう	無料
めいろ	迷路
もの	物
もやした	燃やした
もやす	燃やす
もんく	文句
もんだい    問題
やいた	焼いた
やかん	夜間
やきいし	焼き石
やすい	安い
ゆうじん	友人
ようす	様子
ようもう    羊毛
よにん	四人
よばない	呼ばない
よび	予備
よびつける	呼びつける
よぶ	呼ぶ
よる	夜
りょくち	緑地
りょうかい	了解
れんきん	錬金
れんきんじゅつ	錬金術
れんしゅう	練習
ろくにん	六人
わかった	分かった
わかない	湧かない
わからない	分からない
わかる	分かる
わたし	私
